11111111111111111111111111111111111111111111111111
1E0000000000000C00000C0000000000000000000000000001
1M100101001000001010010000000101001000101001000001
10100100101010100010010000000101001000101010000001
1P0000000C00C0000000000000000000C00000000000000001
10100100101010100010010000000101001000101010000001
10100100101010100010010000000101001000101010000001
10100100101010100010010000000101001000101010000001
10100100101010100010010000000101001000101010000001
10100100101010100010010000000101001000101010000001
10100100101010100010010000000101001000101010000001
10100100101010100010010000000101001000101010000001
10100100101010100010010000000101001000101010000001
10100100101010100010010000000101001000101010000001
10100100101010100010010000000101001000101010000001
10100100101010100010010000000101001000101010000001
10100100101010100010010000000101001000101010000001
10100100101010100010010000000101001000101010000001
10100100101010100010010000000101001000101010000001
10100100101010100010010000000101001000101010000001
10100100101010100010010000000101001000101010000001
11111111111111111111111111111111111111111111111111
